4,2,2,2,2,2,2,2,4
3,1,1,1,1,1,1,1,3
3,1,1,1,4,1,1,1,3
3,1,1,1,3,1,1,1,3
3,1,4,2,4,2,4,1,3
3,1,1,1,3,1,1,1,3
3,1,1,1,4,1,1,1,3
3,1,1,1,1,1,1,1,3
4,2,2,2,2,2,2,2,4
